accountSharingRules=AccountCriteriaBasedSharingRule,AccountOwnerSharingRule,AccountSharingRules
accountTerritorySharingRules=AccountTerritorySharingRule,AccountTerritorySharingRules
analyticSnapshots=AnalyticSnapshot
appMenus=AppMenu
applications=CustomApplication
approvalProcesses=ApprovalProcess
assignmentRules=AssignmentRules
authproviders=AuthProvider
autoResponseRules=AutoResponseRules
aura=AuraDefinitionBundle
callCenters=CallCenter
campaignSharingRules=CampaignCriteriaBasedSharingRule,CampaignOwnerSharingRule,CampaignSharingRules
caseSharingRules=CaseCriteriaBasedSharingRule,CaseOwnerSharingRule,CaseSharingRules
classes=ApexClass
communities=Community
components=ApexComponent
connectedApps=ConnectedApp
contactSharingRules=ContactCriteriaBasedSharingRule,ContactOwnerSharingRule,ContactSharingRules
contentassets=ContentAsset
customApplicationComponents=CustomApplicationComponent
customObjectSharingRules=CustomObjectCriteriaBasedSharingRule,CustomObjectOwnerSharingRule,CustomObjectSharingRules
dashboards=Dashboard
datacategorygroups=DataCategoryGroup
documents=Document
email=EmailTemplate
entitlementProcesses=EntitlementProcess
entitlementTemplates=EntitlementTemplate
escalationRules=EscalationRules
flexipages=FlexiPage
flows=Flow
flowDefinitions=FlowDefinition
globalValueSets=GlobalValueSet
groups=Group
homePageComponents=HomePageComponent
homePageLayouts=HomePageLayout
installedPackages=InstalledPackage
labels=CustomLabels
layouts=Layout
leadSharingRules=LeadCriteriaBasedSharingRule,LeadOwnerSharingRule,LeadSharingRules
letterhead=Letterhead
milestoneTypes=MilestoneType
networks=Network
objectTranslations=CustomObjectTranslation
objects=CustomObject
opportunitySharingRules=OpportunityCriteriaBasedSharingRule,OpportunityOwnerSharingRule,OpportunitySharingRules
pages=ApexPage
permissionsets=PermissionSet
portals=Portal
postTemplates=PostTemplate
profiles=Profile
queues=Queue
quickActions=QuickAction
remoteSiteSettings=RemoteSiteSetting
reportTypes=ReportType
reports=Report
roles=Role
samlssoconfigs=SamlSsoConfig
scontrols=Scontrol
settings=Settings
sharingRules=SharingRules
sites=CustomSite
staticresources=StaticResource
synonymDictionaries=SynonymDictionary
tabs=CustomTab
territories=Territory
translations=Translations
triggers=ApexTrigger
userSharingRules=UserCriteriaBasedSharingRule,UserMembershipSharingRule,UserSharingRules
weblinks=CustomPageWebLink
workflows=Workflow
